[
  {
    "id": "village",
    "theme": "village",
    "size": [20, 16],
    "tiles": [
      [3,3,3,3,3,3,3,3,3,3,3,3,3,3,3,3,3,3,3,3],
      [3,0,0,5,5,0,0,4,4,0,0,4,4,0,0,5,5,0,0,3],
      [3,0,0,5,5,0,0,0,0,0,0,0,0,0,0,5,5,0,0,3],
      [3,0,0,0,0,1,1,1,1,1,1,1,1,1,1,0,0,0,0,3],
      [3,0,0,0,0,1,0,0,0,0,0,0,0,0,1,0,0,0,0,3],
      [3,0,5,5,0,1,0,0,0,0,0,0,0,0,1,0,5,5,0,3],
      [3,0,5,5,0,1,0,0,2,2,2,2,0,0,1,0,5,5,0,3],
      [3,0,0,0,0,1,0,0,2,2,2,2,0,0,1,0,0,0,0,3],
      [3,0,0,0,0,1,0,0,0,0,0,0,0,0,1,0,0,0,0,3],
      [3,0,0,0,0,1,0,0,0,0,0,0,0,0,1,0,0,0,0,3],
      [3,0,0,0,0,1,1,1,1,1,1,1,1,1,1,0,0,0,0,3],
      [3,0,0,0,0,0,0,0,0,0,0,0,0,0,0,0,0,0,0,3],
      [3,0,4,4,0,0,0,0,0,0,0,0,0,0,0,0,4,4,0,3],
      [3,0,4,0,0,0,5,5,0,0,0,0,5,5,0,0,0,4,0,3],
      [3,0,0,0,0,0,5,5,0,0,0,0,5,5,0,0,0,0,0,3],
      [3,3,3,3,3,3,3,3,3,3,3,3,3,3,3,3,3,3,3,3]
    ],
    "spawns": [
      { "entity": "HERO",     "x": 7,  "y": 8  },
      { "entity": "ELDER",    "x": 9,  "y": 4  },
      { "entity": "VILLAGER", "x": 6,  "y": 6  },
      { "entity": "GUARD",    "x": 12, "y": 8  },
      { "entity": "CRYSTAL",  "x": 2,  "y": 1  },
      { "entity": "CRYSTAL",  "x": 17, "y": 1  },
      { "entity": "CRYSTAL",  "x": 1,  "y": 12 },
      { "entity": "CRYSTAL",  "x": 18, "y": 12 },
      { "entity": "CRYSTAL",  "x": 9,  "y": 11 }
    ],
    "goal": { "kind": "collect-all" }
  }
]
