[
  {
    "id": "1-1",
    "theme": "cyberpunk",
    "size": [26, 14],
    "tiles": [
      [3,0,0,0,0,0,0,0,0,0,0,0,0,0,0,0,0,0,0,0,0,0,0,0,0,3],
      [3,0,0,0,0,0,0,0,0,0,0,0,0,0,0,0,0,0,0,0,0,0,0,0,0,3],
      [3,1,1,1,0,0,1,1,1,0,0,1,1,1,0,0,1,1,1,0,0,1,1,1,0,3],
      [3,2,2,2,0,0,2,2,2,0,0,2,2,2,0,0,2,2,2,0,0,2,2,2,0,3],
      [3,0,0,1,1,1,0,0,1,1,1,0,0,1,1,1,0,0,1,1,1,0,0,0,0,3],
      [3,0,0,2,2,2,0,0,2,2,2,0,0,2,2,2,0,0,2,2,2,0,0,0,0,3],
      [3,0,0,0,0,1,1,1,0,0,1,1,1,0,0,1,1,1,0,0,1,1,1,0,0,3],
      [3,0,0,0,0,2,2,2,0,0,2,2,2,0,0,2,2,2,0,0,2,2,2,0,0,3],
      [3,0,0,1,1,1,0,0,1,1,1,0,0,1,1,1,0,0,1,1,1,0,0,0,0,3],
      [3,0,0,2,2,2,0,0,2,2,2,0,0,2,2,2,0,0,2,2,2,0,0,0,0,3],
      [3,0,0,0,0,0,0,0,0,0,0,0,0,0,0,0,0,0,0,0,0,0,0,0,0,3],
      [3,0,0,0,0,0,0,0,0,0,0,0,0,0,0,0,0,0,0,0,0,0,0,0,0,3],
      [1,1,1,1,1,1,1,1,1,1,1,1,1,1,1,1,1,1,1,1,1,1,1,1,1,1],
      [2,2,2,2,2,2,2,2,2,2,2,2,2,2,2,2,2,2,2,2,2,2,2,2,2,2]
    ],
    "spawns": [
      { "entity": "RUNNER", "x": 1, "y": 11 },
      { "entity": "DRONE",  "x": 6, "y": 4  },
      { "entity": "DRONE",  "x": 21, "y": 4 },
      { "entity": "CHIP",   "x": 7,  "y": 1 },
      { "entity": "CHIP",   "x": 19, "y": 1 },
      { "entity": "CHIP",   "x": 4,  "y": 3 },
      { "entity": "CHIP",   "x": 6,  "y": 5 },
      { "entity": "CHIP",   "x": 13, "y": 7 }
    ],
    "goal": { "kind": "pickup" }
  }
]
