[
  {
    "id": "1-1",
    "theme": "dungeon",
    "size": [20, 16],
    "tiles": [
      [1,1,1,1,1,1,1,1,1,1,1,1,1,1,1,1,1,1,1,1],
      [1,0,0,0,0,0,0,0,0,0,0,0,0,0,0,0,0,0,0,1],
      [1,0,3,0,0,0,0,0,0,0,0,0,0,0,0,0,0,3,0,1],
      [1,0,0,0,0,0,0,0,0,0,0,0,0,0,0,0,0,0,0,1],
      [1,0,0,0,1,1,1,0,0,0,0,0,1,1,1,0,0,0,0,1],
      [1,0,0,0,1,0,0,0,0,0,0,0,0,0,1,0,0,0,0,1],
      [1,0,0,0,1,0,0,0,0,0,0,0,0,0,1,0,0,0,0,1],
      [1,0,0,0,0,0,0,0,0,0,0,0,0,0,0,0,0,0,0,1],
      [1,0,0,0,0,0,0,0,0,3,3,0,0,0,0,0,0,0,0,1],
      [1,0,0,0,0,0,0,0,0,3,3,0,0,0,0,0,0,0,0,1],
      [1,0,0,0,1,0,0,0,0,0,0,0,0,0,1,0,0,0,0,1],
      [1,0,0,0,1,1,1,0,0,0,0,0,1,1,1,0,0,0,0,1],
      [1,0,0,0,0,0,0,0,0,0,0,0,0,0,0,0,0,0,0,1],
      [1,0,3,0,0,0,0,0,0,0,0,0,0,0,0,0,0,3,0,1],
      [1,0,0,0,0,0,0,0,0,0,0,0,0,0,0,0,0,0,0,1],
      [1,1,1,1,1,1,1,1,1,1,1,1,1,1,1,1,1,1,1,1]
    ],
    "spawns": [
      { "entity": "WIZARD",   "x": 10, "y": 13 },
      { "entity": "SKELETON", "x": 3,  "y": 3  },
      { "entity": "SKELETON", "x": 16, "y": 3  },
      { "entity": "SKELETON", "x": 7,  "y": 8  },
      { "entity": "ORB",      "x": 10, "y": 1  },
      { "entity": "ORB",      "x": 2,  "y": 10 },
      { "entity": "ORB",      "x": 17, "y": 10 }
    ],
    "goal": { "kind": "collect" }
  }
]
